1111111111111111111111111111111111111111111111111111111
1E00000000000000100000F000010000000C00000C000000000001
1010010100100000100000000000100000000101001000110010101
1010010010101000000111000000100000000001000000100000101
110000000010000000000110011000000000C00000C000000000001
1000011111100000000000000000000000000101000011001100101
10F00000101010101000000F0000010101010001001000000110101
100000000C00C0000000000010000000000000000000000000C0001
110000000010000000011000100000000110000000C000000000001
1000010001000000000000001000000000000101000011001100101
1000000010000011100010101011000001111100001000000110101
1P0000000C00C0000000000000000000000000000000000000C0001
1111111111111111111111111111111111111111111111111111111