111111111
1P0000001
101111101
1C0000E11
111111111
