1111111111111
1F010000000C1
1000010111001
1000010C00001
1000011111001
1P0011E000001
1111111111111