111111
1P0C01
10C001
10E0F1
111111