1111111111111111111111111111111111
1E0000000000000C00000C000000000001
1010010100100000101001000110010101
1010010010101000001000000100000101
110000000010000C00000C000000000001
1000011111100000101000011001100101
1000000010101010001001000000110101
1P0000000C00C0000000000000000C0001
1111111111111111111111111111111111