111111
1P0C01
100001
10E001
111111